*************************************************************
S       *   *       * *       *   *   *   *   *     *       *
* ***** *** ***** * * * ***** *** * * * * * * *** *** ***** *
* *   *   *   * * *   *     *     * * * *   *     *   *     *
* * * *** *** * * ********* ******* * *********** * * * *****
* * *   *   *   * *     * *   *     * *   *     *   * *     *
* * *** *** * *** * *** * *** * ******* * ***** ********* * *
*   * *   *       * *       * *         * *   * *   *     * *
***** *** ********* ******* * *********** * * * *** * ***** *
*     * *     * *   *     *   *   *       * * *   * *   * * *
* *** * ***** * * * * *** *** * * *** * *** * *** * *** * * *
* * *       *     * *   *   *   * *   *   * *         *   * *
* * ******* ******* * * *** ***** * ***** * ***** * * *** * *
* *   *   *         * *   * *     * *     * *     * *   * * *
* *** *** * ***** *** *** * * ***** * ***** * ***** *** * * *
*   *   * *   *   * * * * *     *   *       * *   * * * * * *
* ***** * ***** *** * * * ******* ******* *** * * * * * * * *
* *     * *   *   *   * *   *     *         * * * * * *   * *
* * ***** * * *** *** * *** * *************** * * * * ***** *
* *       * *   * * * *   * *   *     *   *   * * *   *     *
* *** *** * ***** * * *** * *** ***** *** * ***** * *** *****
*   *   * * *     *   *     *   *   *   * *       *   * *   *
*** *** *** * ********* * ***** * * *** * ***** *** * * * * *
*   *     *   *   *     *   *   * * *   *   *   *   * *   * *
* *** *** ******* * ******* * *** * * ***** ********* ***** *
* *   *   *       * *     *   *   *   *       * *     *   * *
* * *** ***** ***** * *** * *** ******* ***** * * ***** * * *
*   *       * *   *   * * *     *     * *   * * *     * *   *
***** ***** * * * ***** * * * *** *** * * * * * ***** ***** *
*       *   * * * *   *   * * *     *   * * * *     *   *   *
* *** * * *** * * *** ***** * * ******* * * * * *** *** * ***
*   * * *     * *   *       * * *   *   * * * *   *     *   *
*** * * *** *** *** *** ***** * * * * *** * * *** ********* *
* * * *   *   *   *     *     *   * *     * *   * *       * *
* * * *** *** *** ******* ********* *********** * * ***** * *
*   * *   *     * *   *   *     *   *   *     * * *   *   * *
***** ***** ***** * * * *** *** * *** * *** * * * * * * *****
*   *   *   *   * * * *   * * * *   * * *   * * * * * * *   *
*** *** * ***** *** * ***** * * *** * *** *** * * *** * * * *
*   *   * *   *   * *     *   * *   *     *   * *   * *   * *
* *** *** * * *** * ***** ***** * *** ***** *** *** * ***** *
*   * * *   * *   * *   *     * *   *   * * *   * *   *     *
*** * * *** * * * *** * ***** * ******* * * * *** ***** *** *
* *   * *   * * * *   * *   * *       *   *   * *       *   *
* ***** * *** * * * * * * * * *** *** * * * *** ********* * *
*   *   *   * * * * * *   * *   * * * * * *   *   *   *   * *
*** * ******* * * * * ***** *** * * * *** *** *** * * *** * *
*     *   *   * * * * *   * * * *   *     *   *   * * *   * *
* *** * * * *** *** * * * * * * *** ******* *** ***** * *** *
*   * * * *   * *   * * * *       *     *   *   *   *   *   *
*** * * * *** * * *** * ***** ******* *** *** *** * *** * ***
*   *   *     * * *   *       *     *   *   * *   * *   *   *
* ************* * * *********** *** *** *** * * *** * ***** *
*     *     *     *   *   *       *   *   *     * * *     * *
***** * *** ***** *** * * * ********* ******* *** * ***** ***
*   *   *   *     * * * *   *   *   *   *     *   *   * *   *
* * ***** *** ***** * * ***** * * * *** * ***** * *** * *** *
* * *   *       * *   * *   * * * *   * * *     * *   *     *
* * * * ***** * * ******* * * * * * * * * * ******* *********
* *   *       *           *   *   * *     *                 E
*************************************************************
